0 2 3 4
1 2 3 4
2 2 3 4
3 2 3 4
4 2 3 4
5 2 3 4
6 2 3 4
7 2 3 4
8 2 3 4
9 2 3 4
10 2 3 4
11 2 3 4
12 2 3 4
13 2 3 4
14 2 3 4
15 2 3 4
16 2 3 4
17 2 3 4
18 2 3 4
19 2 3 4
20 2 3 4
21 2 3 4
22 2 3 4
23 2 3 4
24 2 3 4
25 2 3 4
26 2 3 4
27 2 3 4
28 2 3 4
29 2 3 4
30 2 3 4
31 2 3 4
32 2 3 4
33 2 3 4
34 2 3 4
35 2 3 4
36 2 3 4
37 2 3 4
38 2 3 4
39 2 3 4
40 2 3 4
41 2 3 4
42 2 3 4
43 2 3 4
44 2 3 4
45 2 3 4
46 2 3 4
47 2 3 4
48 2 3 4
49 2 3 4
50 2 3 4
51 2 3 4
52 2 3 4
53 2 3 4
54 2 3 4
55 2 3 4
56 2 3 4
57 2 3 4
58 2 3 4
59 2 3 4
60 2 3 4
61 2 3 4
62 2 3 4
63 2 3 4
