   0    4    6   -1   -1    7    5    1 
   6    5   -1    0    1   -1    6    7 
   0   -1    6    7    0    7   -1    1 
  -1    2    1    0    1    2    3   -1 
  -1    4    3    2    3    4    5   -1 
   2   -1    4    5    6    5   -1    3 
   0    4   -1    6    7   -1    7    1 
   2    3    4   -1   -1    5    2    3 
